{
    "AL": 29,
    "AK": 39,
    "AR": 30,
    "AZ": 22,
    "CA": 45,
    "CO": 31,
    "CT": 32,
    "DE": 3,
    "FL": 33,
    "GA": 2,
    "HI": 18,
    "IA": 5,
    "ID": 0,
    "IL": 13,
    "IN": 49,
    "KS": 38,
    "KY": 9,
    "LA": 10,
    "MA": 34,
    "MD": 16,
    "ME": 23,
    "MI": 44,
    "MN": 36,
    "MO": 12,
    "MS": 1,
    "MT": 43,
    "NC": 50,
    "ND": 48,
    "NE": 8,
    "NH": 26,
    "NJ": 15,
    "NM": 37,
    "NV": 47,
    "NY": 35,
    "OH": 11,
    "OK": 25,
    "OR": 46,
    "PA": 40,
    "RI": 6,
    "SC": 20,
    "SD": 28,
    "TN": 7,
    "TX": 21,
    "UT": 27,
    "VA": 17,
    "VT": 41,
    "WA": 14,
    "WI": 24,
    "WV": 19,
    "WY": 42,
    "DC": 4
}